00000000000000000000000
00000000000000000000000
00000000000000000000000
00000000000011111111111
00000000000000000000000
00011110000000000000000
00000000000000000000000
00000000000000000000000
00000000001111000000000
00000000000000000000000
00000000000000000000000
00000000000000000001110
00000000000001100000000
00000000000000000000000
00011111000000000000000
00000000000000000000000
00000000000000000000000
00000000000001111100000
00000000000000000000000
00001111000000000000000
0000000000000000000P000
00000000000011111111000
00000000000000000000000