00000000000000000000000
00000000000000000000000
00000000000000111111111
00000000000000000000000
00000011110000000000000
00000000000000000000000
00000000000000000000000
11000000000000000000000
00000000000000000000000
00000000000000000000000
00011110000000000000000
00000000000000000000000
00000000000011110000000
00000000000000000000000
00000011000000000000000
00000000000000000000000
00000000000000000000000
00000000011100000000000
00000000000000000000000
00000000000000000111110
00000000000000P00000000
00000000001111100000000
00000000000000000000000