00000000000000000000000
00000000000000000000000
00000000000000000000000
00000000000000111111111
00000000000000000000000
00001111100000000000000
00000000000000000000000
00000000000000000000000
00000000000011110000000
00000000000000000000000
00000000000000000000000
00011110000000000000000
00000000000000000000000
00000000000000000000000
00000000000111100000000
00000000000000000000000
00000000000000000000110
00000000000000000000000
00000000000000000000000
00000000000011111000000
0P000000000000000000000
11111110000000000000000
00000000000000000000000